.#######################
........#.......#......#
###.###.#.#####.###.#..#
#...#.#...#...#...#.#..#
#.###.#####.#.###.#.#..#
#.#...#.....#.#...#.#..#
#.#.###.#####.#.###.####
#.#.......#...#.#......#
###########.#.#.#####..#
#...........#.#........#
#.###################..#
#.................#....#
#.###########.#####.####
#...........#..........#
###########o############