.#######################
......#.......##.......#
#..##########..#######.#
#..#..#.......##.......#
#.##.###.####.##..#.####
#........#........#..#.#
#.########.########.##.#
#.....##.#........#....#
#.#####..########.#.####
#..#..#...........#....#
####..##.#.##.##..#.##.#
#........#.....#..#..#.#
#..####..##########.##.#
#.....#..............#..
#######################o